%%%%%%%%%%%%%%%%%%%%%%%%%
% .....    .....    ... %
%..P  ..  ..   ..  .... %
%    ..       ..  . ... %
%   ..       ..     ...G%
%  ..       ..      ... %
% .......  .......  ... %
%.......  .......   ...o%
%%%%%%%%%%%%%%%%%%%%%%%%%
